{
  "name": "Animal Town - Save Singing Dog!",
  "width": 120,
  "height": 14,
  "bgColors": ["#4488ff", "#66aaff", "#88ccff", "#5ddb5d"],
  "playerStart": { "x": 32, "y": 160 },
  "tiles": [
    [0,0,0,0,0,0,0,0,0,0,0,0,0,0,0,0,0,0,0,0,0,0,0,0,0,0,0,0,0,0,0,0,0,0,0,0,0,0,0,0,0,0,0,0,0,0,0,0,0,0,0,0,0,0,0,0,0,0,0,0,0,0,0,0,0,0,0,0,0,0,0,0,0,0,0,0,0,0,0,0,0,0,0,0,0,0,0,0,0,0,0,0,0,0,0,0,0,0,0,0,0,0,0,3,3,3,3,3,3,3,3,3,3,3,3,3,3,3,3,3],
    [0,0,0,0,0,0,0,0,0,0,0,0,0,0,0,0,0,0,0,0,0,0,0,0,0,0,0,0,0,0,0,0,0,0,0,0,0,0,0,0,0,0,0,0,0,0,0,0,0,0,0,0,0,0,0,0,0,0,0,0,0,0,0,0,0,0,0,0,0,0,0,0,0,0,0,0,0,0,0,0,0,0,0,0,0,0,0,0,0,0,0,0,0,0,0,0,0,0,0,0,0,0,0,0,0,0,0,0,0,0,0,0,0,0,0,0,0,0,0,3],
    [0,0,0,0,0,0,0,0,0,0,0,0,0,0,0,0,0,0,0,0,0,0,0,0,0,0,0,0,0,0,0,0,0,0,0,0,0,0,0,0,0,0,0,0,0,0,0,0,0,0,0,0,0,0,0,0,0,0,0,0,0,0,0,0,0,0,0,0,0,0,0,0,0,0,0,0,0,0,0,0,0,0,0,0,0,0,0,0,0,0,0,0,0,0,0,0,0,0,0,0,0,0,0,0,0,0,0,0,0,0,0,0,0,0,0,0,0,0,0,3],
    [0,0,0,0,0,0,0,0,0,0,0,0,0,0,0,0,0,0,0,0,0,0,0,0,0,4,4,4,0,0,0,0,0,0,0,0,0,0,0,0,0,0,0,0,0,0,0,0,0,0,0,0,0,0,0,0,0,0,0,0,0,0,0,0,0,0,0,0,0,0,0,0,0,0,0,0,0,0,0,0,0,0,0,0,0,0,0,0,0,0,0,0,0,0,0,0,0,0,0,0,0,0,0,0,0,0,0,0,0,0,0,0,0,0,0,0,0,0,0,3],
    [0,0,0,0,0,0,0,0,0,0,0,0,0,0,0,0,0,0,0,0,0,0,0,0,0,0,0,0,0,0,0,0,0,0,0,0,0,0,0,0,0,0,0,0,0,0,0,0,0,5,5,5,0,0,0,0,0,0,0,0,0,0,0,0,0,0,0,0,0,0,0,0,0,0,0,0,0,0,0,0,0,0,0,0,0,0,0,0,0,0,0,0,0,0,0,0,0,0,0,0,0,0,0,0,0,0,0,0,0,5,5,5,0,0,0,0,0,0,0,3],
    [0,0,0,0,0,0,0,0,0,0,0,0,0,0,0,0,0,0,0,5,5,5,0,0,0,0,0,0,0,0,0,0,0,0,0,0,0,0,0,0,0,0,0,0,0,0,0,0,0,0,0,0,0,0,0,0,0,0,0,0,0,0,0,0,0,0,0,0,0,0,0,0,0,0,0,0,0,0,0,0,0,0,0,0,5,5,5,0,0,0,0,0,0,0,0,0,0,0,0,0,0,0,0,0,0,0,0,0,0,0,0,0,0,0,0,0,0,0,0,3],
    [0,0,0,0,0,0,0,0,0,0,0,0,0,0,0,0,0,0,0,0,0,0,0,0,0,0,0,0,0,0,0,0,0,0,5,5,5,0,0,0,0,0,0,0,1,1,1,0,0,0,0,0,0,0,0,0,0,0,0,0,0,0,0,0,0,5,5,5,0,0,0,0,0,0,0,0,0,0,0,0,0,0,0,0,0,0,0,0,0,0,0,0,0,5,5,0,0,0,0,0,0,0,0,0,0,0,5,5,0,0,0,0,0,0,5,5,0,0,0,3],
    [0,0,0,0,0,0,0,0,0,0,0,0,0,0,0,0,0,0,0,0,0,0,0,0,0,0,0,0,0,0,0,0,0,0,0,0,0,0,0,0,0,0,0,0,0,0,0,0,0,0,0,0,0,0,0,1,1,0,0,0,0,0,0,0,0,0,0,0,0,0,0,0,0,0,0,0,0,0,0,0,0,0,0,0,0,0,0,0,0,1,1,0,0,0,0,0,0,0,0,0,0,0,0,0,0,0,0,0,0,0,0,0,0,0,0,0,0,0,0,3],
    [0,0,0,0,0,0,0,0,0,0,0,0,0,0,0,0,0,0,0,0,0,0,0,0,0,0,0,0,0,0,0,0,0,0,0,0,0,0,0,0,0,0,0,0,0,0,0,0,0,0,0,0,0,0,0,0,0,0,0,0,0,0,0,0,0,0,0,0,0,0,0,0,0,0,0,0,0,0,0,0,0,0,0,0,0,0,0,0,0,0,0,0,0,0,0,0,0,0,0,0,0,0,0,0,0,0,0,0,0,0,0,0,0,0,0,0,0,0,0,3],
    [0,0,0,0,0,0,0,0,0,0,0,0,3,3,4,4,3,0,0,0,0,0,0,0,0,0,0,0,0,0,0,0,0,0,0,0,0,0,0,1,1,1,0,0,0,0,0,0,0,0,0,0,0,0,0,0,0,0,0,1,1,1,1,0,0,0,0,0,0,0,0,0,3,3,0,0,0,0,0,0,0,0,0,0,0,0,0,0,0,0,0,0,0,0,0,0,0,0,1,1,0,0,0,0,0,0,0,0,0,0,5,5,5,0,0,0,0,0,0,3],
    [0,0,0,0,0,0,0,0,0,0,0,3,3,3,2,2,3,0,0,0,0,0,0,0,0,0,0,0,0,0,0,0,0,0,0,0,0,0,0,0,0,0,0,0,0,0,0,0,0,0,0,0,0,0,0,0,0,0,0,0,0,0,0,0,0,0,0,0,0,0,0,3,3,3,3,0,0,0,0,0,0,0,0,0,0,0,0,0,0,0,0,0,0,0,0,0,0,0,0,0,0,0,0,0,0,0,0,0,0,0,0,0,0,0,0,0,0,0,0,3],
    [1,1,1,1,1,1,1,1,1,0,0,3,3,3,2,2,3,3,1,1,1,1,1,1,1,0,0,0,1,1,1,1,1,0,0,0,0,0,0,0,0,0,0,1,1,1,1,1,1,0,0,0,1,1,1,1,0,0,0,0,0,0,0,0,0,0,0,0,1,1,1,3,3,3,3,1,1,1,0,0,0,0,1,1,1,1,1,1,0,0,0,1,1,1,0,0,0,0,0,0,0,0,0,1,1,1,1,1,1,1,1,1,1,1,1,1,1,1,1,3],
    [2,2,2,2,2,2,2,2,2,0,0,3,3,3,2,2,3,3,2,2,2,2,2,2,2,0,0,0,2,2,2,2,2,0,0,0,0,0,0,0,0,0,0,2,2,2,2,2,2,0,0,0,2,2,2,2,0,0,0,0,0,0,0,0,0,0,0,0,2,2,2,3,3,3,3,2,2,2,0,0,0,0,2,2,2,2,2,2,0,0,0,2,2,2,0,0,0,0,0,0,0,0,0,3,2,2,2,2,2,2,2,2,2,2,2,2,2,2,2,3],
    [2,2,2,2,2,2,2,2,2,0,0,3,3,3,2,2,3,3,2,2,2,2,2,2,2,0,0,0,2,2,2,2,2,0,0,0,0,0,0,0,0,0,0,2,2,2,2,2,2,0,0,0,2,2,2,2,0,0,0,0,0,0,0,0,0,0,0,0,2,2,2,3,3,3,3,2,2,2,0,0,0,0,2,2,2,2,2,2,0,0,0,2,2,2,0,0,0,0,0,0,0,0,0,3,2,2,2,2,2,2,2,2,2,2,2,2,2,2,2,3]
  ],
  "enemies": [
    { "type": "fox", "x": 320, "y": 160, "patrolLeft": 288, "patrolRight": 368 },
    { "type": "fox", "x": 512, "y": 160, "patrolLeft": 480, "patrolRight": 560 },
    { "type": "bird", "x": 450, "y": 80, "patrolLeft": 400, "patrolRight": 520 },
    { "type": "fox", "x": 700, "y": 96, "patrolLeft": 688, "patrolRight": 752 },
    { "type": "bird", "x": 850, "y": 60, "patrolLeft": 800, "patrolRight": 920 },
    { "type": "fox", "x": 950, "y": 160, "patrolLeft": 928, "patrolRight": 1008 },
    { "type": "bird", "x": 1100, "y": 50, "patrolLeft": 1050, "patrolRight": 1200 },
    { "type": "fox", "x": 1280, "y": 128, "patrolLeft": 1248, "patrolRight": 1360 },
    { "type": "fox", "x": 1400, "y": 160, "patrolLeft": 1360, "patrolRight": 1440 },
    { "type": "bird", "x": 1500, "y": 40, "patrolLeft": 1440, "patrolRight": 1560 }
  ],
  "items": [
    { "type": "carrot", "x": 128, "y": 152 },
    { "type": "carrot", "x": 144, "y": 152 },
    { "type": "carrot", "x": 160, "y": 152 },
    { "type": "carrot", "x": 304, "y": 32 },
    { "type": "carrot", "x": 320, "y": 32 },
    { "type": "carrot", "x": 336, "y": 32 },
    { "type": "carrot", "x": 408, "y": 24 },
    { "type": "carrot", "x": 424, "y": 24 },
    { "type": "carrot", "x": 544, "y": 48 },
    { "type": "carrot", "x": 560, "y": 48 },
    { "type": "heart", "x": 224, "y": 120 },
    { "type": "carrot", "x": 720, "y": 80 },
    { "type": "carrot", "x": 736, "y": 80 },
    { "type": "speed", "x": 800, "y": 56 },
    { "type": "carrot", "x": 880, "y": 152 },
    { "type": "carrot", "x": 896, "y": 152 },
    { "type": "carrot", "x": 960, "y": 72 },
    { "type": "carrot", "x": 976, "y": 72 },
    { "type": "carrot", "x": 1040, "y": 48 },
    { "type": "carrot", "x": 1056, "y": 48 },
    { "type": "heart", "x": 1100, "y": 120 },
    { "type": "carrot", "x": 1200, "y": 80 },
    { "type": "carrot", "x": 1216, "y": 80 },
    { "type": "star", "x": 1320, "y": 40 },
    { "type": "carrot", "x": 1440, "y": 152 },
    { "type": "carrot", "x": 1456, "y": 152 },
    { "type": "heart", "x": 1550, "y": 100 },
    { "type": "carrot", "x": 1600, "y": 80 },
    { "type": "carrot", "x": 1616, "y": 80 }
  ],
  "checkpoints": [
    { "x": 480, "y": 152 },
    { "x": 1050, "y": 120 },
    { "x": 1600, "y": 152 }
  ],
  "bossArea": {
    "triggerX": 1680,
    "left": 1664,
    "right": 1904,
    "bossX": 1800,
    "bossY": 144
  }
}
